                        ########                     #######             #######
                         #######                     #######              ######
                          #######                    #######              ######
                             #  #                     ######              ######
                                #                      #####              ######
                                #                       ####           #########
                                #                        ###   #########   #####
                                #                          ##############      #
                                #                          #  ##########       #
                                #                          #   ########        #
    ######                      #                          #                 ###
     ######                     #                          #                  ##
      #####                     #                          #                   #
       ####                     #                          #                    
       ####                     #                          #                    
        ###                     #                          #                    
       #####                    #                          #                    
       #######                  #                          #                    
      #########                 #                          #                    
     ###########                #                          #                    
     ###############            ########          ##########                    
   #################            ########          ##########                    
 ###################           #########         ############                   
#######################       ##########       #################                
#################################################################               
#################################################################               
 ################## #############################################               
   ###############  ##           ########  #####################                
    #############                #            ################                  
     ############                #              #######                         
                                ########          ##########                    
                                 #######           #########                    
                                 #######           #########                    
                                  ######           #########                    
                                   #####           #########                    
                                    ####            ########                    
                                     ###            ########                    
                                      ##             #######                    
                                                        ####                    
                                                                                
