              ######                 ###                                        
               #####                 ###                                        
                ####                 ###                                        
                 ###                  ##                                        
                  ###                  #                                        
                   ###                 #                                        
                   ####                #                                        
                   # #                 #                                        
                   #                   #                                        
                   #                   #                                        
              ##############################################                    
              ######          ##########       #############                    
               #####             #######       ###############                  
####################                  ##      ######################            
#               ####                          ##########################        
##               ###                         #############################      
##                ##                         ##############################     
#                  #                         ###############################    
                   #                        ############    ################    
                   #                        ###########         #############   
                   #                                              ##############
                   #                                               #############
                   #                                                ############
                   #                                                 ###########
                   #                                                  ##########
                   #                                                   #########
                   #                                                   #########
                   #                                                  ##########
                   #                                                 ########## 
                   #                                                ##########  
          ##########                                              ##############
          ##########                                             ###############
          ##########                                             ###############
          ################                                       ###############
         ###################                                      ##############
##       ###################                                        ############
##########################                                           ########## 
##       ###############                                              ########  
          ###########                                                   #####   
            ######                                                              
