       #                                                                        
      ###                                                                       
     ###########                                                                
     ##        #                                                                
               #                                                                
               #                                                                
               #                                                                
               #                                 ##                             
               #                               #######                          
               #                              #########                         
               #####        ############      ##############                    
               #####        ############     ###############                    
                ####        ############    ###########  ###                    
                ####        ############   ###########     ######               
                 #######################  ###########       #########           
                 ###         ########### ############       ###########         
                  ##           #####################        #############       
                  #              #######  #########         ##############      
                  #                         ######            #############     
                  #                                             ############    
                  #                                              ###############
                  #                                               ##############
                  #                                                #############
                  #                                                 ############
                  #                                                  ###########
                  #                                                  ###########
                  #                                                   ##########
                  #                                                   ##########
                  #                                                   ##########
                  #                                                  #########  
            ########                                                ############
            ########                                                ############
           #########                                                 ###########
##        ##############                                              ##########
#####    ################                                              #########
##########################                                              ########
#########################                                                #######
#######################                                                   ######
#         ########                                                          ### 
                                                                                
