            ########            ########                            #####       
             #######            ########                             #####      
              #######           ########                                 #      
              ###########      #########                                 #      
               #############  ##########                                 #      
                ########################                                 #      
                 #######################                                 #      
                  ###########   ##################                       #      
                  # ######                       #                       #      
                  #                              #                       #      
              ######                             ###########             #######
              ######                             ###########            ########
#              #####                              ###########          #########
### ################                              ##############################
#####           ####                              ##############################
#####            ###                             ###############################
#####             ##                            ############################### 
####               #                          ################################  
##                 #                         #################################  
                   #                        ##############          #########   
                   #                                                  #         
                   #                                                  #         
                   #                                                  #         
                   #                                                  #         
                   #                                                  #         
                   #                                                  #         
                   #                                                  #         
                   #                                                  #         
                   #                                                  #####     
                   #      ######                                   #########    
         ###########      #                                     #########       
          ##########      ##                                   ##########       
          ##################                                  ############      
          ##########     ####                                 ############      
          ##########     ####                                  ###########      
           #########     ###                                   ###########      
           #########                                            ###########     
           #########                                             ##########     
            ########                                             ##########     
             #####                                               ###########    
