     ####                                                                       
   #######                                                                      
 #########                                                                      
###################                                                             
#########         #                                                             
########          #                                                             
#######           #                             ####                            
####              #                            ######                           
                  #                           ########                          
                  #                          ##########                         
                  ##         ###########        #                               
                   #####################   ######                               
                   #        ############ #########                              
                   #        ######################                              
                   #         #####################                              
                   #         #####################                              
                   #          ###################                 ##            
                   #            ##############                   ######         
                   #             ########   #                    #######        
                   #                   #    #                    #########      
                   #                   #    #                    ###############
                   #                        #                    ###############
                   #                        #                    ###############
                   #                        #                     ##############
                   #                        #                      #############
                   #                        #                       ############
                   #                        #                         ##########
                   #                        #                          #########
                   #                        #                           ########
                   #                        #     ##################### #       
                 ###                        #######                   ##########
                 ###                         ######                    #########
#                 ###                         #####                    #########
###               #####                                                 ########
#######             ####                                                 #######
#########           ####                                                  ######
#######################                                                    #####
#####               ##                                                      ####
                                                                              ##
                                                                                
