                                                    ########                   #
                                                    ########                   #
  ##                                                 #######                   #
#######                                               ######                   #
########                                               ######                  #
########                                                ########################
#######                                                   #########             
#######                                                    #########            
      #                                                    # #######            
      #                                                    #    ###             
      ##                           #####                   #                    
      #                            #####                   #                    
      #                            ######                  #                    
      #                             ### ##                 #                    
      #                              #  ###                #                    
      #                                 ##                 #                    
      #                                ###                 #                    
      #  ####                          #                   #                    
      # #######                        #                   #                    
      ##########                       #                   #                    
       ######                   ########           #########                    
    ##########                  ########           #########                    
   ###########                   #######           #############                
   ############     ####################          ################              
   ##################             ######         #################              
    ###########                    #####       ###################              
     ##########                     ##############################              
      ##########                      ##  ######################                
       #########                      #    ###################                  
       #########                      #      #############                      
                                 #######      ##############                    
                                 #######        ############                    
                                  ######         ###########                    
                                  ######         ###########                    
                                   #####          ##########                    
                                   #####           #########                    
                                    ####            ########                    
                                     ###             #######                    
                                                        ###                     
                                                                                
