     ####                                                                       
   #######                                                                      
##########                                                                      
##########                                                                      
##########                                                                      
#########                                                                       
#######                                         ####                            
####                                          #######                           
#                                            #########                          
#                                            ##########                         
#                            ###########       #                                
#                            ###########   #####                                
#                           ############ ########                               
#                           ######################                              
#                            #####################                              
#                             ###################                               
#                  #############################                                
#                  #            ##############                     #            
#                  #             #########  #                     ######        
#                  #                  #     #                    ########       
#                  #                  ##    #                    ###############
#                  #                  ##    #                    ###############
#                  #                   #    #          #########################
#                  #                        #          #          ##############
#                  #                        #          #           #############
#                  #                        #          #            ############
#                  #                        #          #              ##########
#                  #                        #          #               #########
#                  #                        #     ######                  ######
#                  #                        #   ########                  #     
#                  ##                       ########                   #########
#                   #                        #######                   #########
#                   #                         #####                     ########
###                 ##                                                  ########
######              ###                                                  #######
#######################                                                   ######
########            ###                                                    #####
####                #                                                       ####
                                                                              ##
                                                                                
