                        ############                 #######          ##########
                        ############                  ######           #########
                        ############                  ######           #########
                         ###########                   #####           #########
                          #########                     ####           #########
                           ########                     ####         ###########
                             #####                        ##      ##############
                                 #                         #####################
           ####                  #                         #    ############### 
         #######                 #                         #    ###########     
    #######                      #                         #        ############
    #######                      #                         #            ########
    #######                      #                         #              ######
     #######                     #                         #                ####
     #######                     #                         #                 ###
      ######                     #                         #                  ##
      #######                    #                         #                   #
      #######                    #                         #                    
     #########                   #                         #                    
    ###########                  #                         #                    
    ################             #######         ###########                    
   #################            ########       #############                    
 ###################           #########     ###############                    
#############################################################                   
###############################################################                 
################################################################                
####################################### ########################                
 #####################################                    #####                 
  ################      #############                     #                     
    ############           #########                      #                     
                               #########            ########                    
                                ########             #######                    
                                  ######             #######                    
                                   #####             #######                    
                                    ####             #######                    
                                     ###             #######                    
                                      ##              ######                    
                                       #               #####                    
                                                                                
                                                                                
