                ####    ################              ##########################
                ####   #################               #####         ###########
                 ###  ##################                ####         ###########
                ########################                ####          ##########
                #   ####################                 ###          ##########
                #   ####################                  ##         ###########
                #      #################                   #         ###########
             ####         #############                    #        ############
          #######            #########                     #       #############
        #########              #####                       #      ###########   
    #######                                                #        ############
   ########                                                #          ##########
   #########                                               #           #########
  ##########                                               #             #######
  ##########                                               #              ######
   #########                                               #               #####
   #########                                               #                ####
    ########                                               #                  ##
    ########                                               #                    
     #######                                               #                    
     ###############                         ###############                    
    ################                        ################                    
  ##################                      ############    ##                    
 ##################################      ###########      #                     
###################################################       #                     
####################################       ####           #                     
#####################################                     #                     
#####################################                     #                     
 ###############     ################                     #                     
   ##########           #############                     #                     
                          ##############               #####                    
                                  ######               #####                    
                                    ####                ####                    
                                     ###                ####                    
                                      ##                ####                    
                                       #                 ###                    
                                                          #########             
                                                                #####           
                                                                ######          
                                                                 #####          
