     ####                                                                       
   #######                                                                      
##########                                                                      
##########                                                                      
##############################                                                  
#########                    #                   #                              
#######                      #                 #####                            
#####                        #                #######                           
#                            #               #########                          
#                            #              ###########                         
#                            ###########       #                                
#                            ###########   #####                                
#                           ############ ########                               
#                           ######################                              
#                            ####################                               
#                             ###################                               
#                              #################                                
#                               ##############                                  
#                                #########                        #####         
#                                  ###                           ########       
#                                    ###                         ###############
#                                     ##                         ###############
#                                      #                         ###############
#                                      ######          #########################
#                                           #          #           #############
#                                           #          #            ############
#                                           #          #              ##########
#                                           #          #                ########
#                                           #     ######                  ######
#                                           #  ##########                 #     
#                                           ########                   #########
#                                            #######                   #########
#                                             ######                    ########
###                 ##                                                   #######
######              ###                                                  #######
#######################                                                   ######
########            ###                                                    #####
###                                                                         ####
                                                                              ##
                                                                                
